사과	사과
사고ㅏ	사과
사가	사과
ㅅㅏ과	사과
ㅅㅏ고ㅏ	사과
사ㄱㅘ	사과
바나나	바나나
ㅂㅏ나나	바나나
바나ㄴㅏ	바나나
반ㅏ나	바나나
반ㄴ나ㅏ	바나나
바나ㅏㄴ	바나나
자몽	자몽
자모ㅇ	자몽
자옴	자몽
잠ㅗㅇ	자몽
ㅈㅏ몽	자몽
ㅈㅏ모ㅇ	자몽
포도	포도
폳ㅗ	포도
ㅍㅗ도	포도
ㅍㅓ도	포도
오렌지	오렌지
어렌지	오렌지
오레ㄴ지	오렌지
오렞니	오렌지
오린지	오렌지
오랜지	오렌지
올ㅔㄴ지	오렌지